0 0 0 0 0 0 0 0 0 0
0 0 0 0 0 0 0 0 0 0
0 3 4 5 6 7 8 9 1 0
0 3 4 5 6 7 8 9 1 0
0 1 9 8 7 6 5 4 3 0
0 1 9 8 7 6 5 4 3 0
0 3 4 5 6 7 8 9 1 0
0 3 4 5 6 7 8 9 1 0
0 0 0 0 0 0 0 0 0 0
0 0 0 0 0 0 0 0 0 0
