0	0	0	0	0	0	0	0	0	0
1	1	1	1	1	1	1	1	1	1
0	9	9	9	9	9	9	9	9	0
0	0	8	0	0	0	0	8	0	0
0	0	8	0	0	0	0	8	0	0
0	7	7	7	7	7	7	7	7	0
0	0	0	6	0	0	6	0	0	0
0	0	0	6	0	0	6	0	0	0
0	5	5	5	5	5	5	5	5	0
0	0	0	0	0	0	0	0	0	0
