0 0 0 0 0 0 0 0 0 0
0 7 6 0 4 3 0 1 0 0
0 6 0 4 3 0 1 0 3 0
0 0 4 3 0 1 0 3 4 0
0 4 3 0 1 0 3 4 0 0
0 3 0 1 0 3 4 0 6 0
0 0 1 0 3 4 0 6 7 0
0 1 0 3 4 0 6 7 8 0
0 0 0 0 0 0 0 0 0 0
0 0 0 0 0 0 0 0 0 0
